8 8
4 6
WWWWWWWW
WWWX..XW
W.#....W
W.&WW##W
W...#.XW
W.&X.&.W
W......W
WWWWWWWW
