7 7
4 1
WWWWWWW
W..X..W
W.#&##W
W.XX#XW
W.&.#.W
WWX...W
WWWWWWW
