8 8
6 3
WWWWWWWW
W..W..&W
W..&.&.W
W.&#.#.W
W..XWX.W
W...W.&W
WW.....W
WWWWWWWW
