7 7
1 2
WWWWWWW
WX..W.W
W#&.#.W
W...#.W
W.XX..W
W..&..W
WWWWWWW
