11 19
8 11
____WWWWW__________
____W...W__________
____W#..W__________
__WWW..#WW_________
__W..#.#.W_________
WWW.W.WW.W___WWWWWW
W...W.WW.WWWWW..XXW
W.#..#..........XXW
WWWWW.WWW.W.WW..XXW
____W.....WWWWWWWWW
____WWWWWWW________