7 7
5 1
WWWWWWW
WX....W
W#&.W.W
WX..#&W
W.X#..W
W..&..W
WWWWWWW
