7 7
2 1
WWWWWWW
W.....W
W.#XW.W
W&#..XW
W.##..W
W.X.X.W
WWWWWWW
