7 7
5 3
WWWWWWW
W...WWW
W..&&.W
W...#.W
W..#XXW
WWW...W
WWWWWWW
