7 7
3 4
WWWWWWW
W...W.W
W.#&..W
W.X.X.W
W.&##.W
WW..X.W
WWWWWWW
