8 8
1 1
WWWWWWWW
WX..WW.W
W.##...W
W.&X.X.W
W.#.&#XW
W..X.#.W
WWW..&.W
WWWWWWWW
