8 8
4 6
WWWWWWWW
W.&X..XW
W.#....W
W.&WW##W
W...#XXW
W.&&...W
W......W
WWWWWWWW
