8 8
6 5
WWWWWWWW
W.&...XW
W..#.&.W
W.X#.#.W
W&.&..&W
WXW.W..W
W......W
WWWWWWWW
